9,7
0,0,0,0,0,0,0,0,0
0,0,0,0,0,0,0,0,0
0,0,0,1,3,1,0,0,0
0,0,0,3,2,3,0,0,0
0,0,0,1,3,1,0,0,0
0,0,0,0,0,0,0,0,0
0,0,0,0,0,0,0,0,0
0,0,0
1,0,2
4,0,1
5,7,3

