11,11
1,1,0,0,0,0,0,0,0,1,1
1,0,0,0,0,2,0,0,0,0,1
0,0,0,0,1,3,1,0,0,0,0
0,0,0,0,0,0,0,0,0,0,0
0,1,3,0,1,3,1,0,3,1,0
0,2,1,0,3,2,3,0,1,2,0
0,1,3,0,1,3,1,0,3,1,0
0,0,0,0,0,0,0,0,0,0,0
0,0,0,0,1,3,1,0,0,0,0
1,0,0,0,0,2,0,0,0,0,1
1,1,0,0,0,0,0,0,0,1,1

0,1,1
1,2,0
0,0,5
2,2,9
2,3,4
1,3,10
7,0,7

3,9,3
3,8,8
5,10,7
5,9,9
4,7,7
4,10,2
6,10,8

